
         6EY(S)    COMMAND
              # -> fuzzy_sorter
              . -> set_root
              / -> fuzzy_finder
              < -> prev_source
  <2-leftmouse> -> open
           <bs> -> navigate_up
          <c-x> -> clear_filter
           <cr> -> open
          <esc> -> cancel
        <space> -> toggle_node
              > -> next_source
              ? -> show_help
              A -> add_directory
              C -> close_node
              D -> fuzzy_finder_directory
              H -> toggle_hidden
              P -> toggle_preview
              R -> refresh
              S -> open_split
             [g -> prev_git_modified
             ]g -> next_git_modified
              a -> add
              c -> copy
              d -> delete
              e -> toggle_auto_expand_width
              f -> filter_on_submit
              i -> show_file_details
              l -> focus_preview
              m -> move
              o -> show_help
             oc -> order_by_created
             od -> order_by_diagnostics
             og -> order_by_git_status
             om -> order_by_modified
             on -> order_by_name
             os -> order_by_size
             ot -> order_by_type
              p -> paste_from_clipboard
              q -> close_window
              r -> rename
              s -> open_vsplit
              t -> open_tabnew
              w -> open_with_window_picker
              x -> cut_to_clipboard
              y -> copy_to_clipboard

--- 











